#########
#       #
#       #
#o@   @o#
#       #
# A     #
#########