#########
#      o#
# o     #
# @   @ #
#       #
# A     #
#########