  ####
### A#####
#        #
#o@    @o#
##     ###
#  ###  #
#       #
#########
