##### ####
#   ###  #
# @     A#
##@#####@##
# @ooooo@ #
#   #     #
########  #
       ####
